xxxxxxxxxxxx
xqq  x     xxx
xqq  x o  o  x
xqq  xoxxxx  x
xqq    i xx  x
xqq  x x  o xx
xxxxxx xxo o x
  x o  o o o x
  x    x     x
  xxxxxxxxxxxx