xxxxx
xi  x
x o x
xxx x
xqo x
x  qx
xxxxx