XXXXXXXX
XXXNNNXN
XEHBNNXN
XXXNBEXN
XEXXBNXN
XNXNENXX
XBNSBBEX
XNNNENNX
XXXXXXXX