NNNXXXXN
NXXXNNXN
NXNNNNXX
XXBXEENX
XNNBHXNX
XNXNBNNX
XNEEXBXX
XXNNNNXN
NXNNXXXN
NXXXXNNN