9
8
--###---
###1###-
#1BB01#-
##PB0##-
-##B00#-
--#0BB##
###0100#
#11B100#
########

