10
11
###########
#1#00100#1#
#000000000#
#0B00B00B0#
###0###0###
###0###0###
#000000000#
#0000P0000#
##0#####0##
###########