7
7
#######
#10000#
#00B00#
#10#B0#
#00B00#
#1000P#
#######