10
10
##########
#1##11##1#
#00B00B00#
#0##00000#
#000000###
#00B000###
####00####
#00000B00#
#0000000P#
##########